5 10
|--------|
|.P.|..-.|
|..-|.@..|
|.P....-.|
|--------|